47x43
11111111111111111111111111111111111111111111111
10000000000000000000000000000000000000000000001
10000000000000000000000000000000000000000000001
10000000000000000000000000000000000000000000001
10000111111111111111111111111111111111111100001
10000000000000000000000100000000000000000000001
10000000000000000000000100000000000000000000001
10000000000000000000000100000000000000000000001
10000111111100011110000100001111000111111100001
10000000100000000000000000000000000000100000001
10000000100000000000000000000000000000100000001
10000000100000000000000000000000000000100000001
10000000100001000011111111111000010000100000001
10000000000001000000000100000000010000000000001
10000000000001000000000100000000010000000000001
11111111100001000010000100001000010000111111111
11111111100001000010000100001000010000111111111
11111111100001000010000000001000010000111111111
11111111100001000010000000001000010000111111111
11111111100001000011110001111000010000111111111
10000000000000000000000000000000000000000000001
10000000000000000000000000000000000000000000001
10000000000000000000000000000000000000000000001
11111111100001000011110001111000010000111111111
11111111100001000010000000001000010000111111111
11111111100001000010000000001000010000111111111
11111111100001000010000100001000010000111111111
11111111100001000010000100001000010000111111111
10000000000001000000000100000000010000000000001
10000000000001000000000100000000010000000000001
10000000100001000011111111111000010000100000001
10000000100000000000000000000000000000100000001
10000000100000000000000000000000000000100000001
10000000100000000000000000000000000000100000001
10000111111100011110000100001111000111111100001
10000000000000000000000100000000000000000000001
10000000000000000000000100000000000000000000001
10000000000000000000000100000000000000000000001
10000111111111111111111111111111111111111100001
10000000000000000000000000000000000000000000001
10000000000000000000000000000000000000000000001
10000000000000000000000000000000000000000000001
11111111111111111111111111111111111111111111111