36x33
111111111111111111111111111111111111111111111111111111111111111111111111
110000000000000000000000000000000000000000000000000000000000000000000011
110000000000000000000000000000000000000000000000000000000000000000000011
110000001111111111111111111111111111111111111111111111111111111100000011
110000000000000000000000000000000011110000000000000000000000000000000011
11000000000000000011000000000000000011
11000111110001110011001110001111100011
11000001000000000000000000000010000011
11000001000000000000000000000010000011
11000001000100011111111000100010000011
11000000000100000011000000100000000011
11000000000100000011000000100000000011
11111111000100010011001000100011111111
11111111000100010000001000100011111111
11111111000100011100111000100011111111
11111111000100011100111000100011111111
11000000000000000000000000000000000011
11111111000100011100111000100011111111
11111111000100011100111000100011111111
11111111000100010000001000100011111111
11111111000100010011001000100011111111
11000000000100000011000000100000000011
11000000000100000011000000100000000011
11000001000100011111111000100010000011
11000001000000000000000000000010000011
11000001000000000000000000000010000011
11000111110001110011001110001111100011
11000000000000000011000000000000000011
11000000000000000011000000000000000011
11000111111111111111111111111111100011
11000000000000000000000000000000000011
11000000000000000000000000000000000011
111111111111111111111111111111111111111111111111111111111111111111111111
