47x43
111111111111111111111111111111111111
100000000000000000000000000000000001
100000000000000000000000000000000001
100011111111111111111111111111110001
100000000000000001100000000000000001
100000000000000001100000000000000001
100011111001111001100111100111110001
100000100000000000000000000001000001
100000100000000000000000000001000001
100000100010011111111110010001000001
100000000010000001100000010000000001
100000000010000001100000010000000001
111111100010001001100100010001111111
111111100010001000000100010001111111
111111100010001110011100010001111111
111111100010001110011100010001111111
100000000000000000000000000000000001
111111100110011110011110011001111111
111111100110011110011110011001111111
111111100110011000000110011001111111
111111100110011001100110011001111111
100000000110000001100000011000000001
100000000110000001100000011000000001
100000100110011111111110011001000001
100000100000000000000000000001000001
100000100000000000000000000001000001
100011111001111001100111100111110001
100000000000000001100000000000000001
100000000000000001100000000000000001
100011111111111111111111111111110001
100000000000000000000000000000000001
100000000000000000000000000000000001
111111111111111111111111111111111111
