36x33
111111111111111111111111111111111111
120000000000000000000000000000000021
120000000000000000000000000000000021
120211111111111111111111111111112021
120000000000000001100000000000000021
120000000000000001100000000000000021
120211111201111001100111102111112021
120002120000000000000000000021200021
120002120020000000000000020021200021
120002120110011111111110011021200021
120000000110000021120000011000000021
122222200110000001100000011002222221
111111100110011001100110011001111111
111111100110011000000110011001111111
111111100110011110011110011001111111
111111100110011110011110011001111111
100000000000000000000000000000000001
111111100110011110011110011001111111
111111100110011110011110011001111111
111111100110011000000110011001111111
111111100110011001100110011001111111
122222200110000001100000011002222221
120000000110000021120000011000000021
120002120110011111111110011021200021
120002120020000000000000020021200021
120002120000000000000000000021200021
120211111201111001100111102111112021
120000000000000001100000000000000021
120000000000000001100000000000000021
120211111111111111111111111111112021
120000000000000000000000000000000021
120000000000000000000000000000000021
111111111111111111111111111111111111
