47x43
11111111111111111111111111111111111111111111111
12222222222222222222222222222222222222222222221
12000000000000000000000000000000000000000000021
12002222222222222222222222222222222222222220021
12002111111111111111111111111111111111111120021
12002222222222222222222122222222222222222220021
12000000000000000000002120000000000000000000021
12002222222220222222002120022222202222222220021
12002111111120211112002120021111202111111120021
12002222122220222222002220022222202222122220021
12000002120000000000000000000000000002120000021
12000002120022200222222222222200222002120000021
12000002120021200211111111111200212002120000021
12000002220021200222222122222200212002220000021
12000000000021200000002120000000212000000000021
11111111120021200210002120021200212002111111111
11111111120021200210002120021200212002111111111
11111111120021200210000000021200212002111111111
11111111120021200212222022221200212002111111111
11111111120021200211112021111200212002111111111
12222222220022200222222022222200222002222222221
10000000000000000000000000000000000000000000001
12222222220022200222222022222200222002222222221
11111111120021200211112021111200212002111111111
11111111120021200212222022221200212002111111111
11111111120021200210000000021200212002111111111
11111111120021200210002120021200212002111111111
11111111120021200210002120021200212002111111111
12000000000021200000002120000000212000000000021
12000002220021200222222122222200212002220000021
12000002120021200211111111111200212002120000021
12000002120022200222222222222200222002120000021
12000002120000000000000000000000000002120000021
12002222122220222222002220022222202222122220021
12002111111120211112002120021111202111111120021
12002222222220222222002120022222202222222220021
12000000000000000000002120000000000000000000021
12002222222222222222222122222222222222222220021
12002111111111111111111111111111111111111120021
12002222222222222222222222222222222222222220021
12000000000000000000000000000000000000000000021
12222222222222222222222222222222222222222222221
11111111111111111111111111111111111111111111111