36x33
111111111111111111111111111111111111
100000000000000000000000000000000001
100000000000000000000000000000000001
100011111111111111111111111111110001
100000000000000001100000000000000001
100000000000000001100000000000000001
100011111000111001100111000111110001
100000100000000000000000000001000001
100000100000000000000000000001000001
100000100010001111111100010001000001
100000000010000001100000010000000001
100000000010000001100000010000000001
111111100010001001100100010001111111
111111100010001000000100010001111111
111111100010001110011100010001111111
111111100010001110011100010001111111
100000000000000000000000000000000001
111111100010001110011100010001111111
111111100010001110011100010001111111
111111100010001000000100010001111111
111111100010001001100100010001111111
100000000010000001100000010000000001
100000000010000001100000010000000001
100000100010001111111100010001000001
100000100000000000000000000001000001
100000100000000000000000000001000001
100011111000111001100111000111110001
100000000000000001100000000000000001
100000000000000001100000000000000001
100011111111111111111111111111110001
100000000000000000000000000000000001
100000000000000000000000000000000001
111111111111111111111111111111111111
