99 99 99 99 99 99 99 99
99 99 99 99 99 99 99 99
99 99 99 99 99 99 99 99
99 99 99 99 99 99 99 99
99 02 04 04 04 04 03 99
99 06 99 99 99 99 07 99
