99 99 99 99 99 99 99 99
99 99 99 99 99 99 99 99
99 99 99 99 99 99 99 99
99 99 99 99 99 99 99 99
99 00 02 02 02 02 00 99
99 06 99 99 99 99 07 99
